+==========+
|  __  __  |
| +  ++  + |
| |  ||  | |
| +__++__+ |
|  __  __()|
| +  ++  + |
| |  ||  | |
| |  ||  | |
| +__++__+ |
+__________+